KLHL1	Dendrite_development
BBS4	Dendrite_development
LST1	Dendrite_development
SYNGAP1	Dendrite_development
APP	Dendrite_development
DAB1	Dendrite_development
MAP2	Dendrite_development
PRKG1	Dendrite_development
TRAPPC4	Dendrite_development
RELN	Dendrite_development
MAP1B	Dendrite_development
PAK3	Dendrite_development
CD3E	Dendrite_development
CRK	Dendrite_development
TULP1	Dendrite_development
GRIP1	Dendrite_development
BAIAP2	Dendrite_development
MAP1S	Dendrite_development
MECP2	Dendrite_development
GHRL	Dendrite_development
SS18L1	Dendrite_development
GRIN3A	Dendrite_development
STRN	Dendrite_development
DYNLT1	Dendrite_development
HDAC2	Dendrite_development
SCARF1	Dendrite_development
MCF2	Dendrite_development
FEZF2	Dendrite_development
IGSF9	Dendrite_development
BMP7	Dendrite_development
MAP1A	Dendrite_development
FLRT1	Dendrite_development
NTN3	Dendrite_development
CRKL	Dendrite_development
NTN1	Dendrite_development
NRBP2	Neuron_differentiation
DAPK3	Neuron_differentiation
MEF2C	Neuron_differentiation
NIF3L1	Neuron_differentiation
NTRK2	Neuron_differentiation
WNT10A	Neuron_differentiation
HDAC5	Neuron_differentiation
ALDH1A2	Neuron_differentiation
ASCL2	Neuron_differentiation
GAS7	Neuron_differentiation
LHX9	Neuron_differentiation
MYT1L	Neuron_differentiation
PIGT	Neuron_differentiation
WNT5A	Neuron_differentiation
HDAC9	Neuron_differentiation
ADNP2	Neuron_differentiation
RYK	Neuron_differentiation
WNT2B	Neuron_differentiation
LHX6	Neuron_differentiation
RUNX1	Neuron_differentiation
LDB1	Neuron_differentiation
HIPK1	Neuron_differentiation
WNT16	Neuron_differentiation
TUBB3	Neuron_differentiation
VXN	Neuron_differentiation
NAPA	Neuron_differentiation
HDAC1	Neuron_differentiation
WNT7A	Neuron_differentiation
WNT5B	Neuron_differentiation
MBD1	Neuron_differentiation
BTG4	Neuron_differentiation
IL1RAPL1	Neuron_differentiation
CEBPB	Neuron_differentiation
EMX2	Neuron_differentiation
PTPRD	Neuron_differentiation
DNMT3A	Neuron_differentiation
INSM1	Neuron_differentiation
LHX1	Neuron_differentiation
CDK5	Neuron_differentiation
COPS2	Neuron_differentiation
WNT3	Neuron_differentiation
ERBB2	Neuron_differentiation
WNT1	Neuron_differentiation
BRSK1	Neuron_differentiation
CASP3	Neuron_differentiation
POU4F2	Neuron_differentiation
RUNX2	Neuron_differentiation
LMX1B	Neuron_differentiation
TRAPPC9	Neuron_differentiation
ATP2B2	Neuron_differentiation
LHX8	Neuron_differentiation
FZD5	Neuron_differentiation
PPP1CC	Neuron_differentiation
NNAT	Neuron_differentiation
WNT2	Neuron_differentiation
LHX3	Neuron_differentiation
PIN1	Neuron_differentiation
ASCL1	Neuron_differentiation
BRSK2	Neuron_differentiation
SOX15	Neuron_differentiation
SRY	Neuron_differentiation
WNT7B	Neuron_differentiation
WNT4	Neuron_differentiation
WNT11	Neuron_differentiation
S1PR1	Neuron_differentiation
EDN3	Neuron_differentiation
EN2	Neuron_differentiation
TENT2	Neuron_differentiation
WNT9B	Neuron_differentiation
WNT10B	Neuron_differentiation
SMARCA1	Neuron_differentiation
HIPK2	Neuron_differentiation
ITM2C	Neuron_differentiation
MYEF2	Neuron_differentiation
EMX1	Neuron_differentiation
ID3	Neuron_differentiation
GPC2	Neuron_differentiation
RB1	Neuron_differentiation
NEUROG1	Neuron_differentiation
LMX1A	Neuron_differentiation
RNF112	Neuron_differentiation
VAX1	Neuron_differentiation
NLGN4X	Neuron_differentiation
ID4	Neuron_differentiation
CTF1	Neuron_differentiation
MET	Neuron_differentiation
VAX2	Neuron_differentiation
SNPH	Neuron_differentiation
ID2	Neuron_differentiation
WNT9A	Neuron_differentiation
SOX11	Neuron_differentiation
BARHL2	Neuron_differentiation
TRPC6	Neuron_differentiation
OPHN1	Neuron_differentiation
RUNX3	Neuron_differentiation
FZD7	Neuron_differentiation
NEUROG2	Neuron_differentiation
DDIT4	Neuron_differentiation
TRPC5	Neuron_differentiation
WNT6	Neuron_differentiation
LHX5	Neuron_differentiation
FZD2	Neuron_differentiation
SOX3	Neuron_differentiation
WNT8A	Neuron_differentiation
XRN2	Neuron_differentiation
CDK5R1	Neuron_differentiation
ID1	Neuron_differentiation
ATF4	Neuron_differentiation
WNT3A	Neuron_differentiation
FZD1	Neuron_differentiation
SOX21	Neuron_differentiation
LHX2	Neuron_differentiation
FZD4	Neuron_differentiation
IER2	Neuron_differentiation
FZD3	Neuron_differentiation
MAP2K1	Neuron_differentiation
WNT8B	Neuron_differentiation
NGRN	Neuron_differentiation
FZD10	Neuron_differentiation
MTPN	Neuron_differentiation
FZD8	Neuron_differentiation
HOXC8	Neuron_differentiation
GSX1	Neuron_differentiation
CEND1	Neuron_differentiation
HSPA5	Neuron_differentiation
NOTO	Neuron_differentiation
EN1	Neuron_differentiation
SOX2	Neuron_differentiation
HOXD1	Neuron_differentiation
PCSK9	Neuron_differentiation
SOX1	Neuron_differentiation
LHX4	Neuron_differentiation
INSM2	Neuron_differentiation
POU3F2	Neuron_differentiation
DRD1	Neuronal_activity
ANK3	Neuronal_activity
SCN1A	Neuronal_activity
SCN9A	Neuronal_activity
SCN7A	Neuronal_activity
SCN2A	Neuronal_activity
SCN8A	Neuronal_activity
GRIK2	Neuronal_activity
KCNA2	Neuronal_activity
CACNA1G	Neuronal_activity
SCN10A	Neuronal_activity
CACNA1H	Neuronal_activity
SCN11A	Neuronal_activity
P2RX4	Neuronal_activity
GPER1	Neuronal_activity
P2RX1	Neuronal_activity
CHRNA1	Neuronal_activity
SCN4A	Neuronal_activity
P2RX3	Neuronal_activity
SCN5A	Neuronal_activity
SCN3A	Neuronal_activity
MYH14	Neuronal_activity
KCNMB3	Neuronal_activity
GPR88	Neuronal_activity
CACNA1I	Neuronal_activity
KCNA1	Neuronal_activity
KCND2	Neuronal_activity
KCNMB2	Neuronal_activity
KCNMB4	Neuronal_activity
MECP2	Synapse_assembly
CDH9	Synapse_assembly
SDK2	Synapse_assembly
NLGN3	Synapse_assembly
GPM6A	Synapse_assembly
FARP1	Synapse_assembly
SHANK2	Synapse_assembly
CDK5	Synapse_assembly
FLRT3	Synapse_assembly
SDK1	Synapse_assembly
DRD2	Synapse_assembly
NRXN1	Synapse_assembly
CLSTN3	Synapse_assembly
ADGRL3	Synapse_assembly
CDH1	Synapse_assembly
ACHE	Synapse_assembly
ADD2	Synapse_assembly
DNM3	Synapse_assembly
NRXN2	Synapse_assembly
DBNL	Synapse_assembly
SHANK1	Synapse_assembly
PCDHB2	Synapse_assembly
NLGN2	Synapse_assembly
PLXND1	Synapse_assembly
PCDHB4	Synapse_assembly
KIRREL3	Synapse_assembly
NLGN1	Synapse_assembly
BDNF	Synapse_assembly
RAB29	Synapse_assembly
VPS35	Synapse_assembly
SPOCK2	Synapse_assembly
PCDHB9	Synapse_assembly
RYK	Synapse_assembly
CDH2	Synapse_assembly
SPTBN2	Synapse_assembly
ADGRF1	Synapse_assembly
NRCAM	Synapse_assembly
GJA10	Synapse_assembly
PCDHB3	Synapse_assembly
ERBB4	Synapse_assembly
NRG1	Synapse_assembly
PCDHB11	Synapse_assembly
MAP1B	Synapse_assembly
PCLO	Synapse_assembly
SHANK3	Synapse_assembly
PTEN	Synapse_assembly
CRKL	Synapse_assembly
BSN	Synapse_assembly
DSCAM	Synapse_assembly
GNPAT	Synapse_assembly
SLITRK6	Synapse_assembly
POU4F1	Synapse_assembly
PCDHB16	Synapse_assembly
DNER	Synapse_assembly
PCDHB14	Synapse_assembly
PCDHB5	Synapse_assembly
PCDHB6	Synapse_assembly
PCDHB10	Synapse_assembly
PCDHB13	Synapse_assembly
DRD1	Synapse_assembly
FZD5	Synapse_assembly
SLITRK1	Synapse_assembly
